R 1500 600
NO         textures/texture_north.xpm
SO       	textures/texture_north.xpm
WE       textures/texture_north.xpm
EA           textures/texture_north.xpm
S        textures/card1.xpm
F       0,0,0
C         textures/opensky.xpm

11111111111111111111111111111111
10000000000000000000000000000001
10000000000204020204020000000001
10000000000000000000000000000001
10010010010000000000001001001001
10010010010000000000001001001001
10010010010000000000001001001001
10010010010000000000001001001001
10010010010000000000001001001001
10010010010000000000001001001001
10000000020000002000004000000001
10000000040000000000002000000001
10010010010000000000001001001001
10010010010000000000001001001001
10010010010000004000001001001001
10010010010000000000001001001001
10010010010000000000001001001001
10010010010000001000001001001001
10000000020000000000004000000001
10010010010000010100001001001001
10010010010000110110001001001001
10010010010000100010001001001001
10010010010000100010001001001001
10000000000000100010000000000001
1000000000000010N010000000000001
11111111111111111111111111111111
